--level
################################################################################################################################
################################################################################################################################
################################################################################################################################
################################################################################################################################
################################################################################################################################
################################################################################################################################
################################################################################################################    ############
################################################################################################################    ############
##########################################################################################     #################    ############
##########################################################################################     ######    #######    ############
##########################################################################################     -....+    #######    ############
########################################################            ######################     ######    #######    ############
########################################################            ######################     ######    -.....+    ############
########################################################            #######          #####     ######    #########-#############
########################################################            #######          -...+     ######    #########.#############
########################################################            #######          #####     ######    #########.#############
########################################################            -.....+          ################    #########.#############
########################################################            #######          #############################.#############
########################################################            ###########+##################################.#############
########################################################            ###########.##################################+#############
########################################################            ###########.##############################.........#########
########################################################            ###########.##############################.........#########
########################################################            ###########-#################        #####.........#########
########################################################            #########        ############        #####.........#########
###########################################################+#################        ############        #####.........#########
###########################################################.#################        ############        #####.........#########
###########################################################.#################        ############        #####.........#########
###########################################################.#################        ############        -...+.........#########
###########################################################.#################        ################+########.........#########
###########################################################.#################        ################.########.........#########
###########################################################.#################        ################.########.........#########
###########################################################.#########################################.########.........#########
###########################################################-#########################################.#########+################
################################################             ###################    #################.#########.################
################################################             ###################    #################-#########.################
################################################             ###################    ##########        #########.################
################################################             ###################    ##########        #########.################
################################################             ###################    ##########        #########.################
################################################             +...-       #######    ##########        #########.################
################################################             #####       #######    ##########        #########-################
################################################             #####       #######    ##########        ####          ############
################################################             #####       +.....-    ##########        ####          ############
################################################             #####       #######    ##########        ####          ############
################################################             ###########+#######    ##########        ####          ############
################################################             ###########.#######    ##########        ####          ############
################################################             ###########.#####################        ####          ############
################################################             ###########.#################################          ############
########################################################################.#################################          ############
########################################################################.#################################          ############
########################################################################-#################################          ############
####################################################################,,,,,,,,,#############################          ############
####################################################################,,,,,,,,,#############################          ############
####################################################################,,,,,,,,,#############################          ############
####################################################################,,,,,,,,,#############################          ############
################################################################################################################################
################################################################################################################################
################################################################################################################################
################################################################################################################################
################################################################################################################################
################################################################################################################################
################################################################################################################################
################################################################################################################################
################################################################################################################################
################################################################################################################################
