--level
################################################################
################################################################
################################################################
###....-....+.........##########################################
###....######.........##########################################
###....######.........##########################################
###....######.........##########################################
###....######.........##########################################
###....######.........##########################################
#############.........##########################################
#############.........##########################################
#############.........##########################################
#############.........##########################################
#############.........##########################################
#############.........##########################################
#############.........##########################################
##############-#################################################
##############.#################################################
##############.#################################################
##############.#################################################
##############.#################################################
##############+#################################################
#######............#############################################
#######............#############################################
#######............#############################################
#######............#############################################
#######............#############################################
#######............#############################################
#######............#############################################
#######............#############################################
#######............#############################################
################################################################
