--level
################################################################################################################################
################################################################################################################################
################################################################################################################################
################################################################################################################################
##########################################################################              -.......+              #################
##########################################################################              #########              #################
########################################################          ########              #########              #################
########################################################          ########              #########              #################
########################################################          ########              #########              #################
########################################################          ########              #########              #################
########################################################          ########              #########              #################
##############################################################-######################+###########              #################
##############################################################.######################.###########              #################
##############################################################.######################.###########              #################
##############################################################.######################.###########              #######      ####
##############################################################.######################.###########              -.....+      ####
##############################################################.######################.###########              #######      ####
##############################################################+######################-###########              #######      ####
##############################################################          ######         ###############################      ####
##############################################################          ######         ###############################      ####
##############################################################          ######         ###############################      ####
##############################################################          ######         ################..........#####      ####
##############################################################          -....+         ################..........#####      ####
######################################################     ###################         ################..........+...-      ####
######################################################     ###################         ################..........###############
######################################################     #########################+#####     -......+..........###############
######################################################     #########################.#####     ########+#######+################
######################################################     #########################.#####     ########.#######.################
######################################################     #########################.#####     ########.#######.################
######################################################     #########################-#####     ########.#######.################
######################################################     ################          #####     ########.#######.################
######################################################     ##      ########          ##################.#######.################
#########################################################-###      ########          ##################.#######.################
###########################################,,,,,,########.###      ########          ##################-#######.################
###########################################,,,,,,########.###      ########          ###########            ###-################
###########################################,,,,,,########.###      -......+          ###########            ##            ######
###########################################,,,,,,########.###+###################+##+###########            ##            ######
###########################################,,,,,,########.###.###################.##.###########            ##            ######
###########################################,,,,,,########.###.###################.##.###########            ##            ######
###########################################,,,,,,########.###.###################.##.###########            ##            ######
###########################################,,,,,,########+###-###################-##.###########            ##            ######
###########################################,,,,,,-....+           ####            ##.###########            ##            ######
###########################################,,,,,,######           ####            ##-###########            ##            ######
###########################################,,,,,,######           ####            ##    ########+#############            ######
###########################################,,,,,,######           ####            ##    ########.#############            ######
###########################################,,,,,,######           ####            ##    ########.#############            ######
#######################################################           ####            ##    ########.#############            ######
#######################################################           ####            ##    ########.#############            ######
#######################################################           ####            ##    ########.#############            ######
#######################################################           ####            ##    ########.##############+#########+######
###########################################################+##########            ##############.##############.#########.######
###########################################################.####################################-##############.#########.######
###########################################################.##################################    #############.#########.######
###############################              ##############.########    ######################    #############.#########.######
###############################              ##############-########    ######################    #############.#########-######
###############################              ########        #######    ######################    #############.#######    #####
###############################              ########        #######    ######################    #############.#######    #####
###############################              ########        #######    ######################    #############-#######    #####
###############################              -......+        +.....-    ######################    ######          #####    #####
###############################              ########        #######    ################################          ##############
###############################              ########        #######    ################################          ##############
###############################              #######################    ################################          ##############
################################################################################################################################
################################################################################################################################
